----------------------------------------------------------------------------------------------------|
|           |       |                       |                                   |                   |
--------|   |   ----|   |   ------------|   |   --------------------|   ----|   ----------------|   |
|       |   |   |       |       |   |       |   |                   |       |               |       |
|   ----|   |   |   --------|   |   |   ----|   |   |   --------|   ----|   ------------|   |   |   |
|   |       |       |       |   |           |   |   |   |       |   |   |   |               |   |   |
|   |   ----|   ----|   |   |   --------|   |   ----|   |   |   |   |   |   |   ------------|   |   |
|   |       |   |       |   |           |   |           |   |   |   |   |   |                   |   |
|   ----|   |   --------|   --------|   ----------------|   ----|   |   |   --------------------|   |
|       |   |           |           |                       |           |   |           |           |
|   ----|   --------|   |   ----|   --------|   |   --------|   --------|   |   ----|   |   --------|
|           |       |   |   |   |           |   |   |       |       |       |   |       |   |       |
|   --------|   |   |   |   |   --------|   |   ----|   |   ----|   |   ----|   |   ----|   |   |   |
|   |   |       |       |       |           |           |           |           |       |   |   |   |
|   |   |   --------------------|   --------|   ------------|   --------------------|   |   |   |   |
|   |                               |       |       |       |                       |   |   |   |   |
|   |   ----------------------------|   |   ----|   |   |   ------------------------|   |   |   |   |
|   |       |                       |   |   |       |   |   |                           |   |   |   |
|   |   ----|   ----------------|   |   |   |   ----|   |   |   ------------------------|   |   |   |
|   |   |       |               |   |   |   |   |       |       |               |   |       |   |   |
|   ----|   ----|   ----|   |   |   |   |   ----|   ------------|   ----|   |   |   |   --------|   |
|           |   |   |   |   |   |       |       |   |       |       |   |   |       |               |
------------|   |   |   |   ----------------|   |   |   |   |   ----|   |   ----|   ------------|   |
|           |       |   |                   |       |   |   |   |       |   |       |               |
|   --------|   ----|   --------|   ----------------|   |   |   ----|   |   --------|   ------------|
|                               |                       |               |                           |
----------------------------------------------------------------------------------------------------- 🚪 